Class,Package,KILLED,NO_COVERAGE,SURVIVED,TIMED_OUT,Total_Mutant,Mutation_Score
AbsoluteNameLocationStrategy.java,org.apache.commons.configuration2.io,4,0,0,0,4,100.0
AbstractConfiguration.java,org.apache.commons.configuration2,207,3,7,3,220,94.0909090909091
AbstractHierarchicalConfiguration.java,org.apache.commons.configuration2,87,0,4,0,91,95.6043956043956
AbstractImmutableNodeHandler.java,org.apache.commons.configuration2.tree,22,0,0,0,22,100.0
AbstractListDelimiterHandler.java,org.apache.commons.configuration2.convert,25,1,0,0,26,96.15384615384616
AbstractYAMLBasedConfiguration.java,org.apache.commons.configuration2,13,0,3,0,16,81.25
AppletConfiguration.java,org.apache.commons.configuration2.web,0,5,0,0,5,0.0
AutoSaveListener.java,org.apache.commons.configuration2.builder,14,0,0,0,14,100.0
BaseConfiguration.java,org.apache.commons.configuration2,14,0,0,0,14,100.0
BaseConfigurationBuilderProvider.java,org.apache.commons.configuration2.builder.combined,25,0,0,0,25,100.0
BaseConfigurationXMLReader.java,org.apache.commons.configuration2,9,0,1,0,10,90.0
BaseEventSource.java,org.apache.commons.configuration2.event,27,0,0,2,29,93.10344827586206
BaseHierarchicalConfiguration.java,org.apache.commons.configuration2,96,3,7,0,106,90.56603773584906
BasePathLocationStrategy.java,org.apache.commons.configuration2.io,3,0,0,0,3,100.0
BaseWebConfiguration.java,org.apache.commons.configuration2.web,8,0,0,0,8,100.0
BasicBuilderParameters.java,org.apache.commons.configuration2.builder,48,0,3,0,51,94.11764705882352
BasicConfigurationBuilder.java,org.apache.commons.configuration2.builder,66,1,2,0,69,95.65217391304348
BeanHelper.java,org.apache.commons.configuration2.beanutils,47,4,0,0,51,92.15686274509804
BuilderConfigurationWrapperFactory.java,org.apache.commons.configuration2.builder,14,0,0,0,14,100.0
CatalogResolver.java,org.apache.commons.configuration2.resolver,25,9,27,2,63,39.682539682539684
ClasspathLocationStrategy.java,org.apache.commons.configuration2.io,2,0,0,0,2,100.0
CombinedBeanDeclaration.java,org.apache.commons.configuration2.beanutils,25,0,0,0,25,100.0
CombinedBuilderParametersImpl.java,org.apache.commons.configuration2.builder.combined,34,1,0,0,35,97.14285714285714
CombinedConfiguration.java,org.apache.commons.configuration2,116,0,7,6,129,89.92248062015504
CombinedConfigurationBuilder.java,org.apache.commons.configuration2.builder.combined,105,2,10,0,117,89.74358974358975
CombinedConfigurationBuilderProvider.java,org.apache.commons.configuration2.builder.combined,4,0,1,0,5,80.0
CombinedLocationStrategy.java,org.apache.commons.configuration2.io,5,0,0,0,5,100.0
CombinedReloadingController.java,org.apache.commons.configuration2.reloading,10,0,0,0,10,100.0
CompositeConfiguration.java,org.apache.commons.configuration2,68,3,8,0,79,86.07594936708861
ConfigurationAttributePointer.java,org.apache.commons.configuration2.tree.xpath,14,0,1,0,15,93.33333333333333
ConfigurationBuilderEvent.java,org.apache.commons.configuration2.builder,1,0,0,0,1,100.0
ConfigurationBuilderResultCreatedEvent.java,org.apache.commons.configuration2.builder,2,0,0,0,2,100.0
ConfigurationConverter.java,org.apache.commons.configuration2,8,0,0,0,8,100.0
ConfigurationDeclaration.java,org.apache.commons.configuration2.builder.combined,17,2,1,0,20,85.0
ConfigurationDynaBean.java,org.apache.commons.configuration2.beanutils,31,2,2,0,35,88.57142857142857
ConfigurationDynaClass.java,org.apache.commons.configuration2.beanutils,12,2,1,0,15,80.0
ConfigurationErrorEvent.java,org.apache.commons.configuration2.event,4,0,0,0,4,100.0
ConfigurationEvent.java,org.apache.commons.configuration2.event,4,0,0,0,4,100.0
ConfigurationInterpolator.java,org.apache.commons.configuration2.interpol,51,0,0,0,51,100.0
ConfigurationLogger.java,org.apache.commons.configuration2.io,3,0,0,0,3,100.0
ConfigurationLookup.java,org.apache.commons.configuration2,3,0,0,0,3,100.0
ConfigurationMap.java,org.apache.commons.configuration2,14,2,1,0,17,82.35294117647058
ConfigurationNodeIteratorAttribute.java,org.apache.commons.configuration2.tree.xpath,10,0,0,0,10,100.0
ConfigurationNodeIteratorBase.java,org.apache.commons.configuration2.tree.xpath,26,0,1,1,28,92.85714285714286
ConfigurationNodeIteratorChildren.java,org.apache.commons.configuration2.tree.xpath,25,0,0,0,25,100.0
ConfigurationNodePointer.java,org.apache.commons.configuration2.tree.xpath,19,2,3,0,24,79.16666666666666
ConfigurationNodePointerFactory.java,org.apache.commons.configuration2.tree.xpath,5,2,1,0,8,62.5
ConfigurationNodeVisitorAdapter.java,org.apache.commons.configuration2.tree,1,0,0,0,1,100.0
ConfigurationPropertiesFactoryBean.java,org.apache.commons.configuration2.spring,13,4,2,0,19,68.42105263157895
ConfigurationPropertySource.java,org.apache.commons.configuration2.spring,1,2,0,0,3,33.33333333333333
ConfigurationUtils.java,org.apache.commons.configuration2,48,3,3,0,54,88.88888888888889
ConfigurationXMLReader.java,org.apache.commons.configuration2,16,1,2,0,19,84.21052631578947
Configurations.java,org.apache.commons.configuration2.builder.fluent,40,0,0,0,40,100.0
ConstantLookup.java,org.apache.commons.configuration2.interpol,9,0,2,0,11,81.81818181818183
ConstructorArg.java,org.apache.commons.configuration2.beanutils,17,0,0,0,17,100.0
CopyObjectDefaultHandler.java,org.apache.commons.configuration2.builder,4,0,0,0,4,100.0
DataConfiguration.java,org.apache.commons.configuration2,110,3,10,0,123,89.43089430894308
DatabaseBuilderParametersImpl.java,org.apache.commons.configuration2.builder,14,0,0,0,14,100.0
DatabaseConfiguration.java,org.apache.commons.configuration2,48,28,23,0,99,48.484848484848484
DefaultBeanFactory.java,org.apache.commons.configuration2.beanutils,27,0,0,0,27,100.0
DefaultConfigurationKey.java,org.apache.commons.configuration2.tree,132,2,17,8,159,83.01886792452831
DefaultConversionHandler.java,org.apache.commons.configuration2.convert,44,0,1,0,45,97.77777777777777
DefaultEntityResolver.java,org.apache.commons.configuration2.resolver,2,4,1,0,7,28.57142857142857
DefaultExpressionEngine.java,org.apache.commons.configuration2.tree,40,0,1,0,41,97.5609756097561
DefaultExpressionEngineSymbols.java,org.apache.commons.configuration2.tree,20,0,1,0,21,95.23809523809523
DefaultFileSystem.java,org.apache.commons.configuration2.io,31,11,6,0,48,64.58333333333334
DefaultListDelimiterHandler.java,org.apache.commons.configuration2.convert,22,0,0,0,22,100.0
DefaultLookups.java,org.apache.commons.configuration2.interpol,2,0,0,0,2,100.0
DefaultParametersManager.java,org.apache.commons.configuration2.builder,15,0,0,0,15,100.0
DefaultReloadingDetectorFactory.java,org.apache.commons.configuration2.builder,2,0,1,0,3,66.66666666666666
DisabledListDelimiterHandler.java,org.apache.commons.configuration2.convert,2,0,0,0,2,100.0
DynamicCombinedConfiguration.java,org.apache.commons.configuration2,66,67,22,3,158,41.77215189873418
EnvironmentLookup.java,org.apache.commons.configuration2.interpol,0,1,0,0,1,0.0
Event.java,org.apache.commons.configuration2.event,5,0,0,0,5,100.0
EventListenerList.java,org.apache.commons.configuration2.event,33,0,0,3,36,91.66666666666666
EventListenerParameters.java,org.apache.commons.configuration2.builder,6,0,0,0,6,100.0
EventListenerRegistrationData.java,org.apache.commons.configuration2.event,10,4,0,0,14,71.42857142857143
EventType.java,org.apache.commons.configuration2.event,9,0,0,0,9,100.0
ExprLookup.java,org.apache.commons.configuration2.interpol,18,9,0,0,27,66.66666666666666
FileBasedBuilderParametersImpl.java,org.apache.commons.configuration2.builder,36,0,0,0,36,100.0
FileBasedConfigurationBuilder.java,org.apache.commons.configuration2.builder,36,0,3,0,39,92.3076923076923
FileExtensionConfigurationBuilderProvider.java,org.apache.commons.configuration2.builder.combined,12,0,3,0,15,80.0
FileHandler.java,org.apache.commons.configuration2.io,133,2,3,2,140,95.0
FileHandlerReloadingDetector.java,org.apache.commons.configuration2.reloading,22,0,1,1,24,91.66666666666666
FileLocator.java,org.apache.commons.configuration2.io,23,0,1,0,24,95.83333333333334
FileLocatorUtils.java,org.apache.commons.configuration2.io,63,1,3,0,67,94.02985074626866
FileSystem.java,org.apache.commons.configuration2.io,2,0,1,0,3,66.66666666666666
FileSystemLocationStrategy.java,org.apache.commons.configuration2.io,1,0,0,0,1,100.0
FileUtils.java,org.apache.commons.configuration2.io,13,0,5,1,19,68.42105263157895
FindNodeVisitor.java,org.apache.commons.configuration2,4,0,1,0,5,80.0
HierarchicalBuilderParametersImpl.java,org.apache.commons.configuration2.builder,4,0,0,0,4,100.0
HierarchicalConfigurationConverter.java,org.apache.commons.configuration2,17,0,2,0,19,89.47368421052632
HierarchicalConfigurationXMLReader.java,org.apache.commons.configuration2,15,0,0,0,15,100.0
HomeDirectoryLocationStrategy.java,org.apache.commons.configuration2.io,12,0,0,0,12,100.0
INIBuilderParametersImpl.java,org.apache.commons.configuration2.builder,3,4,3,0,10,30.0
INIBuilderProperties.java,org.apache.commons.configuration2.builder,0,2,0,0,2,0.0
INIConfiguration.java,org.apache.commons.configuration2,129,0,29,1,159,81.13207547169812
ImmutableConfigurationInvocationHandler.java,org.apache.commons.configuration2,7,0,0,0,7,100.0
ImmutableNode.java,org.apache.commons.configuration2.tree,59,0,7,0,66,89.39393939393939
InMemoryNodeModel.java,org.apache.commons.configuration2.tree,144,0,5,6,155,92.90322580645162
InterpolatorSpecification.java,org.apache.commons.configuration2.interpol,20,0,0,0,20,100.0
JNDIConfiguration.java,org.apache.commons.configuration2,41,1,7,0,49,83.6734693877551
JSONConfiguration.java,org.apache.commons.configuration2,2,3,0,0,5,40.0
JndiBuilderParametersImpl.java,org.apache.commons.configuration2.builder,4,0,0,0,4,100.0
LegacyListDelimiterHandler.java,org.apache.commons.configuration2.convert,36,1,1,0,38,94.73684210526315
ListDelimiterHandler.java,org.apache.commons.configuration2.convert,1,0,0,0,1,100.0
ManagedReloadingDetector.java,org.apache.commons.configuration2.reloading,2,0,0,0,2,100.0
MapConfiguration.java,org.apache.commons.configuration2,20,1,0,0,21,95.23809523809523
MergeCombiner.java,org.apache.commons.configuration2.tree,14,0,1,0,15,93.33333333333333
ModelTransaction.java,org.apache.commons.configuration2.tree,89,0,3,1,93,95.6989247311828
MultiFileBuilderParametersImpl.java,org.apache.commons.configuration2.builder.combined,10,0,0,0,10,100.0
MultiFileConfigurationBuilder.java,org.apache.commons.configuration2.builder.combined,43,0,1,1,45,95.55555555555556
MultiFileConfigurationBuilderProvider.java,org.apache.commons.configuration2.builder.combined,9,0,2,0,11,81.81818181818183
MultiWrapDynaBean.java,org.apache.commons.configuration2.builder.combined,13,0,0,0,13,100.0
MultiWrapDynaClass.java,org.apache.commons.configuration2.builder.combined,3,1,0,0,4,75.0
NodeAddData.java,org.apache.commons.configuration2.tree,7,0,0,0,7,100.0
NodeCombiner.java,org.apache.commons.configuration2.tree,3,0,0,0,3,100.0
NodeHandlerDecorator.java,org.apache.commons.configuration2.tree,17,0,0,0,17,100.0
NodeNameMatchers.java,org.apache.commons.configuration2.tree,4,0,0,0,4,100.0
NodeSelector.java,org.apache.commons.configuration2.tree,13,0,2,0,15,86.66666666666667
NodeTracker.java,org.apache.commons.configuration2.tree,43,1,1,0,45,95.55555555555556
NodeTreeWalker.java,org.apache.commons.configuration2.tree,16,0,0,0,16,100.0
NodeUpdateData.java,org.apache.commons.configuration2.tree,8,1,0,0,9,88.88888888888889
OverrideCombiner.java,org.apache.commons.configuration2.tree,11,0,0,0,11,100.0
Parameters.java,org.apache.commons.configuration2.builder.fluent,23,0,0,0,23,100.0
ParseException.java,org.apache.commons.configuration2.plist,5,10,11,0,26,19.230769230769234
PatternSubtreeConfigurationWrapper.java,org.apache.commons.configuration2,6,71,3,0,80,7.5
PeriodicReloadingTrigger.java,org.apache.commons.configuration2.reloading,13,0,0,0,13,100.0
PrefixedKeysIterator.java,org.apache.commons.configuration2,13,0,0,0,13,100.0
PropertiesBuilderParametersImpl.java,org.apache.commons.configuration2.builder,10,0,0,0,10,100.0
PropertiesBuilderProperties.java,org.apache.commons.configuration2.builder,0,1,0,0,1,0.0
PropertiesConfiguration.java,org.apache.commons.configuration2,162,2,8,5,177,91.52542372881356
PropertiesConfigurationLayout.java,org.apache.commons.configuration2,123,0,7,4,134,91.7910447761194
PropertyConverter.java,org.apache.commons.configuration2.convert,167,15,1,0,183,91.2568306010929
PropertyListConfiguration.java,org.apache.commons.configuration2.plist,82,10,25,0,117,70.08547008547008
PropertyListParser.java,org.apache.commons.configuration2.plist,107,80,34,0,221,48.41628959276018
PropertyListParserTokenManager.java,org.apache.commons.configuration2.plist,111,139,91,1,342,32.45614035087719
ProvidedURLLocationStrategy.java,org.apache.commons.configuration2.io,1,0,0,0,1,100.0
QueryResult.java,org.apache.commons.configuration2.tree,16,0,1,0,17,94.11764705882352
ReadWriteSynchronizer.java,org.apache.commons.configuration2.sync,4,0,0,2,6,66.66666666666666
ReferenceTracker.java,org.apache.commons.configuration2.tree,14,0,0,0,14,100.0
ReloadingBuilderSupportListener.java,org.apache.commons.configuration2.builder,6,0,0,0,6,100.0
ReloadingCombinedConfigurationBuilder.java,org.apache.commons.configuration2.builder.combined,11,0,1,0,12,91.66666666666666
ReloadingController.java,org.apache.commons.configuration2.reloading,15,0,2,0,17,88.23529411764706
ReloadingEvent.java,org.apache.commons.configuration2.reloading,2,0,0,0,2,100.0
ReloadingFileBasedConfigurationBuilder.java,org.apache.commons.configuration2.builder,14,0,0,0,14,100.0
ReloadingMultiFileConfigurationBuilder.java,org.apache.commons.configuration2.builder.combined,4,0,0,0,4,100.0
ServletConfiguration.java,org.apache.commons.configuration2.web,2,0,0,0,2,100.0
ServletContextConfiguration.java,org.apache.commons.configuration2.web,2,0,0,0,2,100.0
ServletFilterConfiguration.java,org.apache.commons.configuration2.web,2,0,0,0,2,100.0
ServletRequestConfiguration.java,org.apache.commons.configuration2.web,7,0,0,0,7,100.0
SimpleCharStream.java,org.apache.commons.configuration2.plist,23,110,15,3,151,15.2317880794702
StrictConfigurationComparator.java,org.apache.commons.configuration2,13,0,0,0,13,100.0
StringLookupAdapter.java,org.apache.commons.configuration2.interpol,1,0,0,0,1,100.0
SubnodeConfiguration.java,org.apache.commons.configuration2,15,0,0,0,15,100.0
SubsetConfiguration.java,org.apache.commons.configuration2,39,3,0,0,42,92.85714285714286
SystemConfiguration.java,org.apache.commons.configuration2,7,1,0,0,8,87.5
SystemPropertiesLookup.java,org.apache.commons.configuration2.interpol,0,1,0,0,1,0.0
Token.java,org.apache.commons.configuration2.plist,1,2,0,0,3,33.33333333333333
TokenMgrError.java,org.apache.commons.configuration2.plist,0,12,0,0,12,0.0
TrackedNodeHandler.java,org.apache.commons.configuration2.tree,3,0,0,0,3,100.0
TrackedNodeModel.java,org.apache.commons.configuration2.tree,16,0,4,0,20,80.0
TreeData.java,org.apache.commons.configuration2.tree,14,1,0,1,16,87.5
TreeUtils.java,org.apache.commons.configuration2.tree,0,0,11,0,11,0.0
UnionCombiner.java,org.apache.commons.configuration2.tree,8,0,0,0,8,100.0
VFSFileHandlerReloadingDetector.java,org.apache.commons.configuration2.reloading,7,0,0,0,7,100.0
VFSFileSystem.java,org.apache.commons.configuration2.io,9,44,7,0,60,15.0
XMLBeanDeclaration.java,org.apache.commons.configuration2.beanutils,43,1,5,0,49,87.75510204081633
XMLBuilderParametersImpl.java,org.apache.commons.configuration2.builder,15,0,0,0,15,100.0
XMLConfiguration.java,org.apache.commons.configuration2,148,1,19,2,170,87.05882352941177
XMLDocumentHelper.java,org.apache.commons.configuration2,23,0,0,0,23,100.0
XMLListReference.java,org.apache.commons.configuration2,19,0,3,0,22,86.36363636363636
XMLPropertiesConfiguration.java,org.apache.commons.configuration2,37,5,7,1,50,74.0
XMLPropertyListConfiguration.java,org.apache.commons.configuration2.plist,114,12,12,0,138,82.6086956521739
XPathContextFactory.java,org.apache.commons.configuration2.tree.xpath,2,0,0,0,2,100.0
XPathExpressionEngine.java,org.apache.commons.configuration2.tree.xpath,60,0,9,1,70,85.71428571428571
YAMLConfiguration.java,org.apache.commons.configuration2,7,5,1,0,13,53.84615384615385
