Class,Package,KILLED,NO_COVERAGE,RUN_ERROR,SURVIVED,TIMED_OUT,Total_Mutant,Mutation_Score
Abs.java,org.apache.commons.math4.analysis.function,1,0,0,0,0,1,100.0
AbstractConvergenceChecker.java,org.apache.commons.math4.optim,2,0,0,0,0,2,100.0
AbstractCurveFitter.java,org.apache.commons.math4.fitting,14,0,0,0,0,14,100.0
AbstractEvaluation.java,org.apache.commons.math4.fitting.leastsquares,13,0,0,0,0,13,100.0
AbstractFieldIntegrator.java,org.apache.commons.math4.ode,47,2,0,9,6,64,73.4375
AbstractFieldMatrix.java,org.apache.commons.math4.linear,310,40,0,70,1,421,73.63420427553444
AbstractFieldStepInterpolator.java,org.apache.commons.math4.ode.sampling,7,0,0,0,0,7,100.0
AbstractIntegerDistribution.java,org.apache.commons.math4.distribution,31,11,0,19,2,63,49.2063492063492
AbstractIntegrator.java,org.apache.commons.math4.ode,68,1,0,9,8,86,79.06976744186046
AbstractListChromosome.java,org.apache.commons.math4.genetics,0,5,0,0,0,5,0.0
AbstractMultipleLinearRegression.java,org.apache.commons.math4.stat.regression,54,1,0,7,0,62,87.09677419354838
AbstractMultivariateRealDistribution.java,org.apache.commons.math4.distribution,6,0,0,1,0,7,85.71428571428571
AbstractOptimizationProblem.java,org.apache.commons.math4.optim,3,0,0,0,0,3,100.0
AbstractParameterizable.java,org.apache.commons.math4.ode,8,1,0,0,0,9,88.88888888888889
AbstractPolynomialSolver.java,org.apache.commons.math4.analysis.solvers,2,0,0,0,0,2,100.0
AbstractRealDistribution.java,org.apache.commons.math4.distribution,29,20,0,11,2,62,46.774193548387096
AbstractRealMatrix.java,org.apache.commons.math4.linear,319,42,0,50,0,411,77.61557177615572
AbstractSimplex.java,org.apache.commons.math4.optim.nonlinear.scalar.noderiv,66,2,0,4,2,74,89.1891891891892
AbstractStepInterpolator.java,org.apache.commons.math4.ode.sampling,64,5,0,8,1,78,82.05128205128204
AbstractStorelessUnivariateStatistic.java,org.apache.commons.math4.stat.descriptive,24,0,0,3,0,27,88.88888888888889
AbstractUnivariateDifferentiableSolver.java,org.apache.commons.math4.analysis.solvers,3,0,0,0,0,3,100.0
AbstractUnivariateStatistic.java,org.apache.commons.math4.stat.descriptive,4,12,0,0,0,16,25.0
Acos.java,org.apache.commons.math4.analysis.function,2,0,0,0,0,2,100.0
Acosh.java,org.apache.commons.math4.analysis.function,2,0,0,0,0,2,100.0
AdamsBashforthFieldIntegrator.java,org.apache.commons.math4.ode.nonstiff,24,1,0,14,9,48,50.0
AdamsBashforthIntegrator.java,org.apache.commons.math4.ode.nonstiff,47,4,0,22,13,86,54.65116279069767
AdamsFieldIntegrator.java,org.apache.commons.math4.ode.nonstiff,3,0,0,0,0,3,100.0
AdamsFieldStepInterpolator.java,org.apache.commons.math4.ode.nonstiff,13,1,0,2,0,16,81.25
AdamsIntegrator.java,org.apache.commons.math4.ode.nonstiff,3,0,0,0,0,3,100.0
AdamsMoultonFieldIntegrator.java,org.apache.commons.math4.ode.nonstiff,26,1,0,16,9,52,50.0
AdamsMoultonIntegrator.java,org.apache.commons.math4.ode.nonstiff,45,4,0,25,18,92,48.91304347826087
AdamsNordsieckFieldTransformer.java,org.apache.commons.math4.ode.nonstiff,0,69,0,0,0,69,0.0
AdamsNordsieckTransformer.java,org.apache.commons.math4.ode.nonstiff,99,1,0,0,0,100,99.0
AdaptiveStepsizeFieldIntegrator.java,org.apache.commons.math4.ode.nonstiff,24,9,0,13,3,49,48.97959183673469
AdaptiveStepsizeIntegrator.java,org.apache.commons.math4.ode.nonstiff,50,2,0,14,14,80,62.5
Add.java,org.apache.commons.math4.analysis.function,2,0,0,0,0,2,100.0
AggregateSummaryStatistics.java,org.apache.commons.math4.stat.descriptive,36,17,0,6,0,59,61.016949152542374
AgrestiCoullInterval.java,org.apache.commons.math4.stat.interval,17,0,0,0,0,17,100.0
AkimaSplineInterpolator.java,org.apache.commons.math4.analysis.interpolation,97,0,0,6,0,103,94.1747572815534
AnyMatrix.java,org.apache.commons.math4.linear,9,0,0,0,0,9,100.0
ArgUtils.java,org.apache.commons.math4.exception.util,9,0,0,0,0,9,100.0
Array2DRowFieldMatrix.java,org.apache.commons.math4.linear,134,8,0,32,0,174,77.01149425287356
Array2DRowRealMatrix.java,org.apache.commons.math4.linear,172,0,0,29,0,201,85.57213930348259
ArrayFieldVector.java,org.apache.commons.math4.linear,177,40,0,73,0,290,61.03448275862069
ArrayRealVector.java,org.apache.commons.math4.linear,293,5,0,35,0,333,87.98798798798799
Asin.java,org.apache.commons.math4.analysis.function,2,0,0,0,0,2,100.0
Asinh.java,org.apache.commons.math4.analysis.function,2,0,0,0,0,2,100.0
Atan.java,org.apache.commons.math4.analysis.function,2,0,0,0,0,2,100.0
Atan2.java,org.apache.commons.math4.analysis.function,1,0,0,0,0,1,100.0
Atanh.java,org.apache.commons.math4.analysis.function,2,0,0,0,0,2,100.0
BOBYQAOptimizer.java,org.apache.commons.math4.optim.nonlinear.scalar.noderiv,1008,175,0,351,29,1563,64.49136276391555
BaseAbstractUnivariateIntegrator.java,org.apache.commons.math4.analysis.integration,14,1,0,3,0,18,77.77777777777779
BaseAbstractUnivariateSolver.java,org.apache.commons.math4.analysis.solvers,21,1,0,1,1,24,87.5
BaseMultiStartMultivariateOptimizer.java,org.apache.commons.math4.optim,0,35,0,0,0,35,0.0
BaseMultivariateOptimizer.java,org.apache.commons.math4.optim,28,0,0,1,0,29,96.55172413793103
BaseOptimizer.java,org.apache.commons.math4.optim,14,3,0,0,0,17,82.35294117647058
BaseRuleFactory.java,org.apache.commons.math4.analysis.integration.gauss,13,0,0,0,0,13,100.0
BaseSecantSolver.java,org.apache.commons.math4.analysis.solvers,40,0,0,15,0,55,72.72727272727273
BesselJ.java,org.apache.commons.math4.special,240,12,0,115,1,368,65.21739130434783
BiDiagonalTransformer.java,org.apache.commons.math4.linear,213,3,0,9,0,225,94.66666666666667
BicubicInterpolatingFunction.java,org.apache.commons.math4.analysis.interpolation,111,0,0,0,0,111,100.0
BicubicInterpolator.java,org.apache.commons.math4.analysis.interpolation,35,0,0,6,1,42,83.33333333333334
BigReal.java,org.apache.commons.math4.util,15,2,0,2,0,19,78.94736842105263
BigRealField.java,org.apache.commons.math4.util,5,0,0,0,0,5,100.0
BinaryChromosome.java,org.apache.commons.math4.genetics,16,1,0,1,1,19,84.21052631578947
BinaryMutation.java,org.apache.commons.math4.genetics,3,0,0,0,0,3,100.0
BinomialTest.java,org.apache.commons.math4.stat.inference,31,0,0,3,2,36,86.11111111111111
BisectionSolver.java,org.apache.commons.math4.analysis.solvers,5,0,0,3,0,8,62.5
BlockFieldMatrix.java,org.apache.commons.math4.linear,750,103,0,103,0,956,78.45188284518828
BlockRealMatrix.java,org.apache.commons.math4.linear,885,39,0,104,0,1028,86.08949416342413
BracketFinder.java,org.apache.commons.math4.optim.univariate,46,5,0,38,0,89,51.68539325842697
BracketingNthOrderBrentSolver.java,org.apache.commons.math4.analysis.solvers,119,0,0,24,1,144,82.63888888888889
BrentOptimizer.java,org.apache.commons.math4.optim.univariate,94,2,0,19,0,115,81.73913043478261
BrentSolver.java,org.apache.commons.math4.analysis.solvers,4,0,0,0,0,4,100.0
CMAESOptimizer.java,org.apache.commons.math4.optim.nonlinear.scalar.noderiv,332,46,0,138,1,517,64.21663442940039
CalinskiHarabasz.java,org.apache.commons.math4.ml.clustering.evaluation,46,3,0,2,0,51,90.19607843137256
CanberraDistance.java,org.apache.commons.math4.ml.distance,10,0,0,1,0,11,90.9090909090909
CardanEulerSingularityException.java,org.apache.commons.math4.geometry.euclidean.threed,0,0,0,1,0,1,0.0
Cbrt.java,org.apache.commons.math4.analysis.function,2,0,0,0,0,2,100.0
Ceil.java,org.apache.commons.math4.analysis.function,1,0,0,0,0,1,100.0
CentralPivotingStrategy.java,org.apache.commons.math4.util,0,5,0,0,0,5,0.0
CentroidCluster.java,org.apache.commons.math4.ml.clustering,1,0,0,0,0,1,100.0
ChebyshevDistance.java,org.apache.commons.math4.ml.distance,1,0,0,0,0,1,100.0
ChiSquareTest.java,org.apache.commons.math4.stat.inference,105,0,0,17,0,122,86.0655737704918
CholeskyDecomposition.java,org.apache.commons.math4.linear,93,2,0,2,0,97,95.87628865979381
Chromosome.java,org.apache.commons.math4.genetics,8,1,0,0,0,9,88.88888888888889
ChromosomePair.java,org.apache.commons.math4.genetics,2,1,0,0,0,3,66.66666666666666
ClassicalRungeKuttaFieldIntegrator.java,org.apache.commons.math4.ode.nonstiff,8,0,0,0,0,8,100.0
ClassicalRungeKuttaFieldStepInterpolator.java,org.apache.commons.math4.ode.nonstiff,4,0,0,1,0,5,80.0
ClassicalRungeKuttaStepInterpolator.java,org.apache.commons.math4.ode.nonstiff,71,0,0,1,0,72,98.61111111111111
ClopperPearsonInterval.java,org.apache.commons.math4.stat.interval,30,0,0,0,0,30,100.0
Cluster.java,org.apache.commons.math4.ml.clustering,12,1,0,0,0,13,92.3076923076923
ClusterEvaluator.java,org.apache.commons.math4.ml.clustering,1,1,0,3,0,5,20.0
Clusterer.java,org.apache.commons.math4.ml.clustering,1,0,0,0,1,2,50.0
CombinatoricsUtils.java,org.apache.commons.math4.util,25,2,0,20,0,47,53.191489361702125
ComplexFormat.java,org.apache.commons.math4.complex,38,7,0,6,0,51,74.50980392156863
CompositeFormat.java,org.apache.commons.math4.util,36,0,0,5,0,41,87.8048780487805
ConfidenceInterval.java,org.apache.commons.math4.stat.interval,5,1,0,5,0,11,45.45454545454545
ConjugateGradient.java,org.apache.commons.math4.linear,19,3,0,11,1,34,55.88235294117647
Constant.java,org.apache.commons.math4.analysis.function,2,0,0,0,0,2,100.0
ContinuousOutputFieldModel.java,org.apache.commons.math4.ode,0,75,0,0,0,75,0.0
ContinuousOutputModel.java,org.apache.commons.math4.ode,45,2,0,58,4,109,41.284403669724774
ConvergenceException.java,org.apache.commons.math4.exception,0,0,0,1,0,1,0.0
CorrelatedRandomVectorGenerator.java,org.apache.commons.math4.random,14,4,0,1,0,19,73.68421052631578
Cos.java,org.apache.commons.math4.analysis.function,2,0,0,0,0,2,100.0
Cosh.java,org.apache.commons.math4.analysis.function,2,0,0,0,0,2,100.0
Covariance.java,org.apache.commons.math4.stat.correlation,35,1,0,3,0,39,89.74358974358975
CycleCrossover.java,org.apache.commons.math4.genetics,13,1,0,2,7,23,56.52173913043478
DBSCANClusterer.java,org.apache.commons.math4.ml.clustering,0,30,0,0,0,30,0.0
DSCompiler.java,org.apache.commons.math4.analysis.differentiation,717,0,0,23,1,741,96.76113360323887
Decimal64.java,org.apache.commons.math4.util,90,9,0,1,0,100,90.0
Decimal64Field.java,org.apache.commons.math4.util,4,0,0,0,0,4,100.0
DefaultFieldMatrixChangingVisitor.java,org.apache.commons.math4.linear,0,1,0,1,0,2,0.0
DefaultFieldMatrixPreservingVisitor.java,org.apache.commons.math4.linear,0,0,0,1,0,1,0.0
DefaultIterativeLinearSolverEvent.java,org.apache.commons.math4.linear,5,2,0,0,0,7,71.42857142857143
DefaultMeasurementModel.java,org.apache.commons.math4.filter,2,0,0,0,0,2,100.0
DefaultProcessModel.java,org.apache.commons.math4.filter,5,0,0,0,0,5,100.0
DefaultRealMatrixChangingVisitor.java,org.apache.commons.math4.linear,0,1,0,1,0,2,0.0
DefaultRealMatrixPreservingVisitor.java,org.apache.commons.math4.linear,1,0,0,0,0,1,100.0
DefaultTransformer.java,org.apache.commons.math4.util,6,1,0,1,0,8,75.0
DenseWeightedEvaluation.java,org.apache.commons.math4.fitting.leastsquares,3,0,0,0,0,3,100.0
DerivativeStructure.java,org.apache.commons.math4.analysis.differentiation,194,0,0,30,0,224,86.60714285714286
DescriptiveStatistics.java,org.apache.commons.math4.stat.descriptive,59,1,0,9,0,69,85.5072463768116
Dfp.java,org.apache.commons.math4.dfp,1042,54,0,45,16,1157,90.06050129645635
DfpDec.java,org.apache.commons.math4.dfp,111,13,0,10,2,136,81.61764705882352
DfpField.java,org.apache.commons.math4.dfp,46,10,0,33,2,91,50.54945054945055
DfpMath.java,org.apache.commons.math4.dfp,144,37,0,15,11,207,69.56521739130434
DiagonalMatrix.java,org.apache.commons.math4.linear,64,0,0,8,0,72,88.88888888888889
DifferentiatorVectorMultivariateJacobianFunction.java,org.apache.commons.math4.fitting.leastsquares,10,0,0,0,0,10,100.0
DimensionMismatchException.java,org.apache.commons.math4.exception,1,0,0,0,0,1,100.0
Divide.java,org.apache.commons.math4.analysis.function,2,0,0,0,0,2,100.0
DividedDifferenceInterpolator.java,org.apache.commons.math4.analysis.interpolation,16,0,0,0,0,16,100.0
DormandPrince54FieldIntegrator.java,org.apache.commons.math4.ode.nonstiff,13,0,0,0,1,14,92.85714285714286
DormandPrince54FieldStepInterpolator.java,org.apache.commons.math4.ode.nonstiff,4,0,0,1,0,5,80.0
DormandPrince54Integrator.java,org.apache.commons.math4.ode.nonstiff,24,0,0,0,2,26,92.3076923076923
DormandPrince54StepInterpolator.java,org.apache.commons.math4.ode.nonstiff,77,0,0,2,1,80,96.25
DormandPrince853FieldIntegrator.java,org.apache.commons.math4.ode.nonstiff,14,0,0,1,1,16,87.5
DormandPrince853FieldStepInterpolator.java,org.apache.commons.math4.ode.nonstiff,11,0,0,1,0,12,91.66666666666666
DormandPrince853Integrator.java,org.apache.commons.math4.ode.nonstiff,30,0,0,1,22,53,56.60377358490566
DormandPrince853StepInterpolator.java,org.apache.commons.math4.ode.nonstiff,260,0,0,6,1,267,97.37827715355806
DoublePoint.java,org.apache.commons.math4.ml.clustering,5,2,0,2,0,9,55.55555555555556
DummyLocalizable.java,org.apache.commons.math4.exception.util,0,3,0,0,0,3,0.0
DummyStepHandler.java,org.apache.commons.math4.ode.sampling,0,2,0,0,0,2,0.0
EarthMoversDistance.java,org.apache.commons.math4.ml.distance,7,0,0,1,0,8,87.5
EigenDecomposition.java,org.apache.commons.math4.linear,414,24,0,49,2,489,84.66257668711657
ElitisticListPopulation.java,org.apache.commons.math4.genetics,12,0,0,3,0,15,80.0
EmbeddedRungeKuttaFieldIntegrator.java,org.apache.commons.math4.ode.nonstiff,43,3,0,19,11,76,56.57894736842105
EmbeddedRungeKuttaIntegrator.java,org.apache.commons.math4.ode.nonstiff,80,0,0,12,19,111,72.07207207207207
EmpiricalDistribution.java,org.apache.commons.math4.distribution,13,123,0,2,0,138,9.420289855072465
EnumeratedDistribution.java,org.apache.commons.math4.distribution,26,9,0,6,0,41,63.41463414634146
EnumeratedIntegerDistribution.java,org.apache.commons.math4.distribution,43,0,0,4,0,47,91.48936170212765
EnumeratedRealDistribution.java,org.apache.commons.math4.distribution,54,0,0,4,0,58,93.10344827586206
EquationsMapper.java,org.apache.commons.math4.ode,6,0,0,0,0,6,100.0
EuclideanDistance.java,org.apache.commons.math4.ml.distance,1,0,0,0,0,1,100.0
EulerFieldIntegrator.java,org.apache.commons.math4.ode.nonstiff,4,0,0,0,0,4,100.0
EulerFieldStepInterpolator.java,org.apache.commons.math4.ode.nonstiff,2,0,0,3,0,5,40.0
EulerStepInterpolator.java,org.apache.commons.math4.ode.nonstiff,15,0,0,2,0,17,88.23529411764706
EvaluationRmsChecker.java,org.apache.commons.math4.fitting.leastsquares,3,0,0,0,0,3,100.0
EventFilter.java,org.apache.commons.math4.ode.events,25,4,0,11,0,40,62.5
EventState.java,org.apache.commons.math4.ode.events,78,6,0,14,3,101,77.22772277227723
ExceptionContext.java,org.apache.commons.math4.exception.util,46,1,0,0,0,47,97.87234042553192
Exp.java,org.apache.commons.math4.analysis.function,2,0,0,0,0,2,100.0
ExpandableStatefulODE.java,org.apache.commons.math4.ode,36,4,0,0,0,40,90.0
Expm1.java,org.apache.commons.math4.analysis.function,2,0,0,0,0,2,100.0
ExponentialDecayFunction.java,org.apache.commons.math4.ml.neuralnet.sofm.util,14,0,0,1,0,15,93.33333333333333
FastCosineTransformer.java,org.apache.commons.math4.transform,57,0,0,1,0,58,98.27586206896551
FastFourierTransformer.java,org.apache.commons.math4.transform,143,0,0,3,1,147,97.27891156462584
FastHadamardTransformer.java,org.apache.commons.math4.transform,43,1,0,0,2,46,93.47826086956522
FastMath.java,org.apache.commons.math4.util,2143,51,0,348,13,2555,83.8747553816047
FastMathCalc.java,org.apache.commons.math4.util,0,252,0,0,0,252,0.0
FastMathLiteralArrays.java,org.apache.commons.math4.util,4,0,0,1,0,5,80.0
FastSineTransformer.java,org.apache.commons.math4.transform,42,0,0,1,0,43,97.67441860465115
FeatureInitializerFactory.java,org.apache.commons.math4.ml.neuralnet,6,0,0,2,0,8,75.0
FieldBracketingNthOrderBrentSolver.java,org.apache.commons.math4.analysis.solvers,82,5,0,29,1,117,70.08547008547008
FieldDenseMatrix.java,org.apache.commons.math4.field.linalg,84,2,0,7,0,93,90.32258064516128
FieldEquationsMapper.java,org.apache.commons.math4.ode,53,0,0,3,0,56,94.64285714285714
FieldEventState.java,org.apache.commons.math4.ode.events,1,69,0,0,0,70,1.4285714285714286
FieldExpandableODE.java,org.apache.commons.math4.ode,14,0,0,1,0,15,93.33333333333333
FieldHermiteInterpolator.java,org.apache.commons.math4.analysis.interpolation,51,0,0,4,0,55,92.72727272727272
FieldLUDecomposition.java,org.apache.commons.math4.field.linalg,101,1,0,8,0,110,91.81818181818183
FieldLUDecomposition.java,org.apache.commons.math4.linear,145,0,0,5,0,150,96.66666666666667
FieldODEState.java,org.apache.commons.math4.ode,17,0,0,0,0,17,100.0
FieldODEStateAndDerivative.java,org.apache.commons.math4.ode,4,0,0,0,0,4,100.0
FieldRotation.java,org.apache.commons.math4.geometry.euclidean.threed,0,251,0,0,0,251,0.0
FieldStepNormalizer.java,org.apache.commons.math4.ode.sampling,0,28,0,0,0,28,0.0
FieldVector3D.java,org.apache.commons.math4.geometry.euclidean.threed,132,0,0,29,0,161,81.98757763975155
FilterType.java,org.apache.commons.math4.ode.events,75,0,0,21,0,96,78.125
FiniteDifferencesDifferentiator.java,org.apache.commons.math4.analysis.differentiation,87,0,0,7,0,94,92.5531914893617
FirstMoment.java,org.apache.commons.math4.stat.descriptive.moment,9,1,0,2,0,12,75.0
FirstOrderConverter.java,org.apache.commons.math4.ode,7,0,0,0,0,7,100.0
FixedElapsedTime.java,org.apache.commons.math4.genetics,5,0,0,3,0,8,62.5
FixedGenerationCount.java,org.apache.commons.math4.genetics,5,1,0,1,1,8,62.5
Floor.java,org.apache.commons.math4.analysis.function,1,0,0,0,0,1,100.0
FourthMoment.java,org.apache.commons.math4.stat.descriptive.moment,24,1,0,2,0,27,88.88888888888889
Frequency.java,org.apache.commons.math4.stat,1,64,0,0,0,65,1.5384615384615385
FunctionUtils.java,org.apache.commons.math4.analysis,95,15,0,1,0,111,85.58558558558559
FuzzyKMeansClusterer.java,org.apache.commons.math4.ml.clustering,52,15,0,13,11,91,57.14285714285714
GLSMultipleLinearRegression.java,org.apache.commons.math4.stat.regression,8,3,0,1,0,12,66.66666666666666
GTest.java,org.apache.commons.math4.stat.inference,99,0,0,10,0,109,90.82568807339449
GaussIntegrator.java,org.apache.commons.math4.analysis.integration.gauss,13,0,0,0,0,13,100.0
GaussIntegratorFactory.java,org.apache.commons.math4.analysis.integration.gauss,17,0,0,0,0,17,100.0
GaussNewtonOptimizer.java,org.apache.commons.math4.fitting.leastsquares,32,3,0,2,2,39,82.05128205128204
Gaussian.java,org.apache.commons.math4.analysis.function,66,0,0,4,0,70,94.28571428571428
GaussianCurveFitter.java,org.apache.commons.math4.fitting,56,10,0,16,0,82,68.29268292682927
GaussianRandomGenerator.java,org.apache.commons.math4.random,1,0,0,0,0,1,100.0
GeneticAlgorithm.java,org.apache.commons.math4.genetics,17,0,0,12,0,29,58.620689655172406
GeometricMean.java,org.apache.commons.math4.stat.descriptive.moment,13,2,0,4,0,19,68.42105263157895
GillFieldIntegrator.java,org.apache.commons.math4.ode.nonstiff,8,0,0,0,0,8,100.0
GillFieldStepInterpolator.java,org.apache.commons.math4.ode.nonstiff,5,0,0,0,0,5,100.0
GillStepInterpolator.java,org.apache.commons.math4.ode.nonstiff,78,0,0,0,0,78,100.0
GradientFunction.java,org.apache.commons.math4.analysis.differentiation,7,0,0,0,0,7,100.0
GradientMultivariateOptimizer.java,org.apache.commons.math4.optim.nonlinear.scalar,6,0,0,1,0,7,85.71428571428571
GraggBulirschStoerIntegrator.java,org.apache.commons.math4.ode.nonstiff,291,3,0,89,48,431,67.51740139211137
GraggBulirschStoerStepInterpolator.java,org.apache.commons.math4.ode.nonstiff,156,7,0,16,10,189,82.53968253968253
HaltonSequenceGenerator.java,org.apache.commons.math4.random,24,0,0,1,2,27,88.88888888888889
HarmonicCurveFitter.java,org.apache.commons.math4.fitting,74,1,0,28,0,103,71.84466019417476
HarmonicOscillator.java,org.apache.commons.math4.analysis.function,35,0,0,0,0,35,100.0
HermiteInterpolator.java,org.apache.commons.math4.analysis.interpolation,60,0,0,4,0,64,93.75
HermiteRuleFactory.java,org.apache.commons.math4.analysis.integration.gauss,69,0,0,1,1,71,97.1830985915493
HessenbergTransformer.java,org.apache.commons.math4.linear,104,1,0,4,0,109,95.41284403669725
HighamHall54FieldIntegrator.java,org.apache.commons.math4.ode.nonstiff,15,0,0,0,2,17,88.23529411764706
HighamHall54FieldStepInterpolator.java,org.apache.commons.math4.ode.nonstiff,4,0,0,1,0,5,80.0
HighamHall54Integrator.java,org.apache.commons.math4.ode.nonstiff,11,0,0,1,9,21,52.38095238095239
HighamHall54StepInterpolator.java,org.apache.commons.math4.ode.nonstiff,146,0,0,1,0,147,99.31972789115646
HitHistogram.java,org.apache.commons.math4.ml.neuralnet.twod.util,0,12,0,0,0,12,0.0
Identity.java,org.apache.commons.math4.analysis.function,2,0,0,0,0,2,100.0
InferenceTestUtils.java,org.apache.commons.math4.stat.inference,39,11,0,0,0,50,78.0
InitialGuess.java,org.apache.commons.math4.optim,1,0,0,0,0,1,100.0
IntegerSequence.java,org.apache.commons.math4.util,34,1,0,3,4,42,80.95238095238095
InterpolatingMicrosphere.java,org.apache.commons.math4.analysis.interpolation,46,3,0,13,0,62,74.19354838709677
InterpolatingMicrosphere2D.java,org.apache.commons.math4.analysis.interpolation,6,1,0,0,0,7,85.71428571428571
IntervalUtils.java,org.apache.commons.math4.stat.interval,12,0,0,2,0,14,85.71428571428571
Inverse.java,org.apache.commons.math4.analysis.function,3,0,0,0,0,3,100.0
IterationEvent.java,org.apache.commons.math4.util,1,0,0,0,0,1,100.0
IterationManager.java,org.apache.commons.math4.util,10,1,0,2,1,14,71.42857142857143
IterativeLegendreGaussIntegrator.java,org.apache.commons.math4.analysis.integration,26,0,0,2,0,28,92.85714285714286
IterativeLinearSolver.java,org.apache.commons.math4.linear,4,6,0,3,0,13,30.76923076923077
IterativeLinearSolverEvent.java,org.apache.commons.math4.linear,0,1,0,0,0,1,0.0
JacobiPreconditioner.java,org.apache.commons.math4.linear,1,17,0,0,0,18,5.555555555555555
JacobianFunction.java,org.apache.commons.math4.analysis.differentiation,10,0,0,0,0,10,100.0
JacobianMatrices.java,org.apache.commons.math4.ode,92,4,0,14,0,110,83.63636363636363
KMeansPlusPlusCentroidInitializer.java,org.apache.commons.math4.ml.clustering.initialization,30,5,0,4,0,39,76.92307692307693
KMeansPlusPlusClusterer.java,org.apache.commons.math4.ml.clustering,18,22,0,7,6,53,33.9622641509434
KalmanFilter.java,org.apache.commons.math4.filter,20,3,0,11,0,34,58.82352941176471
KendallsCorrelation.java,org.apache.commons.math4.stat.correlation,82,0,0,3,1,86,95.34883720930233
KohonenTrainingTask.java,org.apache.commons.math4.ml.neuralnet.sofm,2,0,0,0,0,2,100.0
KohonenUpdateAction.java,org.apache.commons.math4.ml.neuralnet.sofm,0,14,0,0,0,14,0.0
KolmogorovSmirnovTest.java,org.apache.commons.math4.stat.inference,367,79,0,60,10,516,71.12403100775194
KthSelector.java,org.apache.commons.math4.util,35,0,0,10,6,51,68.62745098039215
Kurtosis.java,org.apache.commons.math4.stat.descriptive.moment,57,1,0,5,0,63,90.47619047619048
LUDecomposition.java,org.apache.commons.math4.linear,137,0,0,3,0,140,97.85714285714285
LaguerreRuleFactory.java,org.apache.commons.math4.analysis.integration.gauss,30,0,0,0,0,30,100.0
LaguerreSolver.java,org.apache.commons.math4.analysis.solvers,43,11,0,19,5,78,55.12820512820513
LearningFactorFunctionFactory.java,org.apache.commons.math4.ml.neuralnet.sofm,12,0,0,0,0,12,100.0
LeastSquaresAdapter.java,org.apache.commons.math4.fitting.leastsquares,7,0,0,0,0,7,100.0
LeastSquaresBuilder.java,org.apache.commons.math4.fitting.leastsquares,13,1,0,0,0,14,92.85714285714286
LeastSquaresConverter.java,org.apache.commons.math4.optim.nonlinear.scalar,26,0,0,0,0,26,100.0
LeastSquaresFactory.java,org.apache.commons.math4.fitting.leastsquares,30,8,0,2,1,41,73.17073170731707
LegendreHighPrecisionRuleFactory.java,org.apache.commons.math4.analysis.integration.gauss,34,0,0,0,4,38,89.47368421052632
LegendreRuleFactory.java,org.apache.commons.math4.analysis.integration.gauss,0,0,0,73,0,73,0.0
LevenbergMarquardtOptimizer.java,org.apache.commons.math4.fitting.leastsquares,354,7,0,44,0,405,87.4074074074074
LineSearch.java,org.apache.commons.math4.optim.nonlinear.scalar,8,0,0,0,0,8,100.0
LinearConstraint.java,org.apache.commons.math4.optim.linear,13,8,0,3,0,24,54.166666666666664
LinearConstraintSet.java,org.apache.commons.math4.optim.linear,1,3,0,0,0,4,25.0
LinearInterpolator.java,org.apache.commons.math4.analysis.interpolation,16,0,0,1,0,17,94.11764705882352
LinearObjectiveFunction.java,org.apache.commons.math4.optim.linear,13,4,0,1,0,18,72.22222222222221
LinearOptimizer.java,org.apache.commons.math4.optim.linear,11,0,0,0,0,11,100.0
ListPopulation.java,org.apache.commons.math4.genetics,19,0,0,5,0,24,79.16666666666666
LocalizedFormats.java,org.apache.commons.math4.exception.util,0,6,0,0,0,6,0.0
LocationFinder.java,org.apache.commons.math4.ml.neuralnet.twod.util,10,0,0,0,0,10,100.0
LoessInterpolator.java,org.apache.commons.math4.analysis.interpolation,103,2,0,13,1,119,86.5546218487395
Log.java,org.apache.commons.math4.analysis.function,2,0,0,0,0,2,100.0
Log10.java,org.apache.commons.math4.analysis.function,2,0,0,0,0,2,100.0
Log1p.java,org.apache.commons.math4.analysis.function,2,0,0,0,0,2,100.0
Logistic.java,org.apache.commons.math4.analysis.function,36,0,0,5,0,41,87.8048780487805
Logit.java,org.apache.commons.math4.analysis.function,43,0,0,5,0,48,89.58333333333334
LutherFieldIntegrator.java,org.apache.commons.math4.ode.nonstiff,8,0,0,0,0,8,100.0
LutherFieldStepInterpolator.java,org.apache.commons.math4.ode.nonstiff,3,0,0,2,0,5,60.0
LutherStepInterpolator.java,org.apache.commons.math4.ode.nonstiff,256,0,0,10,0,266,96.2406015037594
ManhattanDistance.java,org.apache.commons.math4.ml.distance,1,0,0,0,0,1,100.0
MannWhitneyUTest.java,org.apache.commons.math4.stat.inference,31,0,0,3,0,34,91.17647058823529
MapUtils.java,org.apache.commons.math4.ml.neuralnet,11,41,0,1,0,53,20.754716981132077
MathArrays.java,org.apache.commons.math4.util,4,328,0,0,0,332,1.2048192771084338
MathIllegalNumberException.java,org.apache.commons.math4.exception,1,0,0,0,0,1,100.0
MathInternalError.java,org.apache.commons.math4.exception,0,1,0,0,0,1,0.0
MathParseException.java,org.apache.commons.math4.exception,0,1,0,1,0,2,0.0
MathRuntimeException.java,org.apache.commons.math4.exception,4,1,0,0,0,5,80.0
MathUtils.java,org.apache.commons.math4.util,49,0,0,30,1,80,61.25000000000001
MatrixDimensionMismatchException.java,org.apache.commons.math4.linear,4,0,0,0,0,4,100.0
MatrixUtils.java,org.apache.commons.math4.linear,0,214,0,0,0,214,0.0
Max.java,org.apache.commons.math4.analysis.function,1,0,0,0,0,1,100.0
Max.java,org.apache.commons.math4.stat.descriptive.rank,15,1,0,4,0,20,75.0
MaxCountExceededException.java,org.apache.commons.math4.exception,2,0,0,0,0,2,100.0
MaxEval.java,org.apache.commons.math4.optim,2,1,0,1,0,4,50.0
MaxIter.java,org.apache.commons.math4.optim,2,1,0,1,0,4,50.0
Mean.java,org.apache.commons.math4.stat.descriptive.moment,27,2,0,8,0,37,72.97297297297297
Median.java,org.apache.commons.math4.stat.descriptive.rank,2,1,0,0,0,3,66.66666666666666
MedianOf3PivotingStrategy.java,org.apache.commons.math4.util,9,0,0,10,0,19,47.368421052631575
MicrosphereProjectionInterpolator.java,org.apache.commons.math4.analysis.interpolation,9,0,0,2,0,11,81.81818181818183
MidPointIntegrator.java,org.apache.commons.math4.analysis.integration,25,0,0,7,2,34,73.52941176470588
MidpointFieldIntegrator.java,org.apache.commons.math4.ode.nonstiff,4,0,0,0,0,4,100.0
MidpointFieldStepInterpolator.java,org.apache.commons.math4.ode.nonstiff,4,0,0,1,0,5,80.0
MidpointStepInterpolator.java,org.apache.commons.math4.ode.nonstiff,31,0,0,1,0,32,96.875
MillerUpdatingRegression.java,org.apache.commons.math4.stat.regression,473,60,0,115,1,649,72.88135593220339
Min.java,org.apache.commons.math4.analysis.function,1,0,0,0,0,1,100.0
Min.java,org.apache.commons.math4.stat.descriptive.rank,15,1,0,4,0,20,75.0
MiniBatchKMeansClusterer.java,org.apache.commons.math4.ml.clustering,3,50,0,10,2,65,4.615384615384616
Minus.java,org.apache.commons.math4.analysis.function,3,0,0,0,0,3,100.0
MixtureMultivariateNormalDistribution.java,org.apache.commons.math4.distribution,4,0,0,0,0,4,100.0
MixtureMultivariateRealDistribution.java,org.apache.commons.math4.distribution,21,13,0,1,0,35,60.0
MullerSolver.java,org.apache.commons.math4.analysis.solvers,47,3,0,28,0,78,60.256410256410255
MullerSolver2.java,org.apache.commons.math4.analysis.solvers,46,5,0,12,2,65,70.76923076923077
MultiDimensionMismatchException.java,org.apache.commons.math4.exception,2,2,0,0,0,4,50.0
MultiDirectionalSimplex.java,org.apache.commons.math4.optim.nonlinear.scalar.noderiv,16,0,0,1,1,18,88.88888888888889
MultiKMeansPlusPlusClusterer.java,org.apache.commons.math4.ml.clustering,3,0,0,2,1,6,50.0
MultiStartMultivariateOptimizer.java,org.apache.commons.math4.optim.nonlinear.scalar,7,3,0,1,0,11,63.63636363636363
MultiStartUnivariateOptimizer.java,org.apache.commons.math4.optim.univariate,28,1,0,4,0,33,84.84848484848484
Multiply.java,org.apache.commons.math4.analysis.function,2,0,0,0,0,2,100.0
MultistepFieldIntegrator.java,org.apache.commons.math4.ode,29,5,0,10,2,46,63.04347826086957
MultistepIntegrator.java,org.apache.commons.math4.ode,31,12,0,14,3,60,51.66666666666667
MultivariateFunctionMappingAdapter.java,org.apache.commons.math4.optim.nonlinear.scalar,27,0,0,10,0,37,72.97297297297297
MultivariateFunctionPenaltyAdapter.java,org.apache.commons.math4.optim.nonlinear.scalar,23,0,0,9,0,32,71.875
MultivariateNormalDistribution.java,org.apache.commons.math4.distribution,45,4,0,3,0,52,86.53846153846155
MultivariateNormalMixtureExpectationMaximization.java,org.apache.commons.math4.distribution.fitting,92,6,0,11,0,109,84.40366972477065
MultivariateOptimizer.java,org.apache.commons.math4.optim.nonlinear.scalar,9,0,0,0,1,10,90.0
MultivariateSummaryStatistics.java,org.apache.commons.math4.stat.descriptive,96,0,0,22,0,118,81.35593220338984
NPointCrossover.java,org.apache.commons.math4.genetics,21,1,0,2,0,24,87.5
NaturalRanking.java,org.apache.commons.math4.stat.ranking,71,1,0,4,0,76,93.42105263157895
NeighbourhoodSizeFunctionFactory.java,org.apache.commons.math4.ml.neuralnet.sofm,4,0,0,0,0,4,100.0
NelderMeadSimplex.java,org.apache.commons.math4.optim.nonlinear.scalar.noderiv,62,0,0,5,0,67,92.53731343283582
Network.java,org.apache.commons.math4.ml.neuralnet,50,1,0,6,0,57,87.71929824561403
Neuron.java,org.apache.commons.math4.ml.neuralnet,21,0,0,2,0,23,91.30434782608695
NeuronSquareMesh2D.java,org.apache.commons.math4.ml.neuralnet.twod,156,7,0,5,0,168,92.85714285714286
NeuronString.java,org.apache.commons.math4.ml.neuralnet.oned,40,2,0,3,0,45,88.88888888888889
NevilleInterpolator.java,org.apache.commons.math4.analysis.interpolation,1,0,0,0,0,1,100.0
NewtonRaphsonSolver.java,org.apache.commons.math4.analysis.solvers,6,0,0,1,0,7,85.71428571428571
NoBracketingException.java,org.apache.commons.math4.exception,0,4,0,0,0,4,0.0
NonLinearConjugateGradientOptimizer.java,org.apache.commons.math4.optim.nonlinear.scalar.gradient,49,1,0,2,0,52,94.23076923076923
NonMonotonicSequenceException.java,org.apache.commons.math4.exception,4,0,0,4,0,8,50.0
NonNegativeConstraint.java,org.apache.commons.math4.optim.linear,1,0,0,0,0,1,100.0
NonPositiveDefiniteMatrixException.java,org.apache.commons.math4.linear,0,3,0,2,0,5,0.0
NonSymmetricMatrixException.java,org.apache.commons.math4.linear,0,3,0,0,0,3,0.0
NordsieckStepInterpolator.java,org.apache.commons.math4.ode.sampling,50,3,0,3,13,69,72.46376811594203
NormalApproximationInterval.java,org.apache.commons.math4.stat.interval,13,0,0,0,0,13,100.0
NullArgumentException.java,org.apache.commons.math4.exception,0,3,0,1,0,4,0.0
NumberIsTooLargeException.java,org.apache.commons.math4.exception,2,0,0,1,0,3,66.66666666666666
NumberIsTooSmallException.java,org.apache.commons.math4.exception,2,0,0,1,0,3,66.66666666666666
OLSMultipleLinearRegression.java,org.apache.commons.math4.stat.regression,40,0,0,0,0,40,100.0
ObjectiveFunction.java,org.apache.commons.math4.optim.nonlinear.scalar,1,0,0,0,0,1,100.0
ObjectiveFunctionGradient.java,org.apache.commons.math4.optim.nonlinear.scalar,1,0,0,0,0,1,100.0
OnePointCrossover.java,org.apache.commons.math4.genetics,13,0,0,0,0,13,100.0
OneWayAnova.java,org.apache.commons.math4.stat.inference,38,0,0,7,0,45,84.44444444444444
OpenIntToDoubleHashMap.java,org.apache.commons.math4.util,99,0,0,26,8,133,74.43609022556392
OpenIntToFieldHashMap.java,org.apache.commons.math4.util,97,1,0,28,8,134,72.38805970149254
OpenMapRealMatrix.java,org.apache.commons.math4.linear,54,9,0,8,1,72,75.0
OpenMapRealVector.java,org.apache.commons.math4.linear,178,18,0,26,0,222,80.18018018018019
OptimumImpl.java,org.apache.commons.math4.fitting.leastsquares,10,1,0,0,0,11,90.9090909090909
OrderedCrossover.java,org.apache.commons.math4.genetics,12,0,0,5,0,17,70.58823529411765
OutOfRangeException.java,org.apache.commons.math4.exception,2,0,0,0,0,2,100.0
PSquarePercentile.java,org.apache.commons.math4.stat.descriptive.rank,157,3,0,20,0,180,87.22222222222223
Pair.java,org.apache.commons.math4.util,18,1,0,5,0,24,75.0
ParameterConfiguration.java,org.apache.commons.math4.ode,1,0,0,1,0,2,50.0
ParameterJacobianWrapper.java,org.apache.commons.math4.ode,15,2,0,0,0,17,88.23529411764706
ParameterizedWrapper.java,org.apache.commons.math4.ode,0,6,0,0,0,6,0.0
PearsonsCorrelation.java,org.apache.commons.math4.stat.correlation,61,0,0,4,0,65,93.84615384615384
Percentile.java,org.apache.commons.math4.stat.descriptive.rank,155,4,0,25,0,184,84.23913043478261
PiecewiseBicubicSplineInterpolatingFunction.java,org.apache.commons.math4.analysis.interpolation,48,13,0,3,0,64,75.0
PiecewiseBicubicSplineInterpolator.java,org.apache.commons.math4.analysis.interpolation,8,0,0,2,0,10,80.0
PointValuePair.java,org.apache.commons.math4.optim,6,0,0,1,0,7,85.71428571428571
PointVectorValuePair.java,org.apache.commons.math4.optim,7,3,0,2,0,12,58.333333333333336
PolynomialCurveFitter.java,org.apache.commons.math4.fitting,7,1,0,0,0,8,87.5
PolynomialFunction.java,org.apache.commons.math4.analysis.polynomials,87,24,0,12,0,123,70.73170731707317
PolynomialFunctionLagrangeForm.java,org.apache.commons.math4.analysis.polynomials,83,10,0,6,0,99,83.83838383838383
PolynomialFunctionNewtonForm.java,org.apache.commons.math4.analysis.polynomials,41,4,0,6,0,51,80.3921568627451
PolynomialSplineFunction.java,org.apache.commons.math4.analysis.polynomials,42,12,0,0,0,54,77.77777777777779
PolynomialsUtils.java,org.apache.commons.math4.analysis.polynomials,97,1,0,7,0,105,92.38095238095238
Pow.java,org.apache.commons.math4.analysis.function,1,0,0,0,0,1,100.0
PowellOptimizer.java,org.apache.commons.math4.optim.nonlinear.scalar.noderiv,34,0,0,30,0,64,53.125
Power.java,org.apache.commons.math4.analysis.function,2,0,0,0,0,2,100.0
PreconditionedIterativeLinearSolver.java,org.apache.commons.math4.linear,8,2,0,4,0,14,57.14285714285714
Product.java,org.apache.commons.math4.stat.descriptive.summary,21,1,0,2,0,24,87.5
QRDecomposition.java,org.apache.commons.math4.linear,180,0,0,6,0,186,96.7741935483871
QuantizationError.java,org.apache.commons.math4.ml.neuralnet.twod.util,0,12,0,0,0,12,0.0
QuasiSigmoidDecayFunction.java,org.apache.commons.math4.ml.neuralnet.sofm.util,10,0,0,1,0,11,90.9090909090909
RRQRDecomposition.java,org.apache.commons.math4.linear,32,0,0,6,0,38,84.21052631578947
RandomCentroidInitializer.java,org.apache.commons.math4.ml.clustering.initialization,6,1,0,1,0,8,75.0
RandomKey.java,org.apache.commons.math4.genetics,40,2,0,1,3,46,86.95652173913044
RandomKeyMutation.java,org.apache.commons.math4.genetics,2,0,0,0,0,2,100.0
RandomPivotingStrategy.java,org.apache.commons.math4.util,0,9,0,0,0,9,0.0
RandomUtils.java,org.apache.commons.math4.random,43,18,1,14,6,82,52.4390243902439
RealLinearOperator.java,org.apache.commons.math4.linear,0,1,0,0,0,1,0.0
RealMatrixFormat.java,org.apache.commons.math4.linear,47,11,0,5,0,63,74.60317460317461
RealVector.java,org.apache.commons.math4.linear,61,166,0,5,1,233,26.180257510729614
RealVectorFormat.java,org.apache.commons.math4.linear,28,4,0,4,1,37,75.67567567567568
RectangularCholeskyDecomposition.java,org.apache.commons.math4.linear,46,0,0,2,0,48,95.83333333333334
RegressionResults.java,org.apache.commons.math4.stat.regression,66,25,0,15,0,106,62.264150943396224
Relationship.java,org.apache.commons.math4.optim.linear,2,1,0,1,0,4,50.0
ResizableDoubleArray.java,org.apache.commons.math4.util,102,1,0,27,0,130,78.46153846153847
RiddersSolver.java,org.apache.commons.math4.analysis.solvers,21,4,0,8,0,33,63.63636363636363
Rint.java,org.apache.commons.math4.analysis.function,1,0,0,0,0,1,100.0
RngAdaptor.java,org.apache.commons.math4.random,0,7,0,13,0,20,0.0
RombergIntegrator.java,org.apache.commons.math4.analysis.integration,21,2,0,6,0,29,72.41379310344827
RotationOrder.java,org.apache.commons.math4.geometry.euclidean.threed,4,0,0,0,0,4,100.0
RungeKuttaFieldIntegrator.java,org.apache.commons.math4.ode.nonstiff,53,1,0,8,6,68,77.94117647058823
RungeKuttaFieldStepInterpolator.java,org.apache.commons.math4.ode.nonstiff,14,0,0,0,0,14,100.0
RungeKuttaIntegrator.java,org.apache.commons.math4.ode.nonstiff,96,1,0,11,2,110,87.27272727272727
RungeKuttaStepInterpolator.java,org.apache.commons.math4.ode.nonstiff,34,0,0,5,0,39,87.17948717948718
SchurTransformer.java,org.apache.commons.math4.linear,248,0,0,38,2,288,86.11111111111111
SearchInterval.java,org.apache.commons.math4.optim.univariate,9,0,0,2,0,11,81.81818181818183
SecantSolver.java,org.apache.commons.math4.analysis.solvers,16,1,0,3,0,20,80.0
SecondMoment.java,org.apache.commons.math4.stat.descriptive.moment,12,0,0,2,0,14,85.71428571428571
SemiVariance.java,org.apache.commons.math4.stat.descriptive.moment,21,9,0,1,0,31,67.74193548387096
Sigmoid.java,org.apache.commons.math4.analysis.function,46,0,0,1,0,47,97.87234042553192
Signum.java,org.apache.commons.math4.analysis.function,1,0,0,0,0,1,100.0
SimpleBounds.java,org.apache.commons.math4.optim,5,0,0,0,0,5,100.0
SimpleCurveFitter.java,org.apache.commons.math4.fitting,4,2,0,0,0,6,66.66666666666666
SimplePointChecker.java,org.apache.commons.math4.optim,15,0,0,2,0,17,88.23529411764706
SimpleRegression.java,org.apache.commons.math4.stat.regression,219,49,0,23,0,291,75.25773195876289
SimpleUnivariateValueChecker.java,org.apache.commons.math4.optim.univariate,11,0,0,2,0,13,84.61538461538461
SimpleValueChecker.java,org.apache.commons.math4.optim,11,0,0,2,0,13,84.61538461538461
SimpleVectorValueChecker.java,org.apache.commons.math4.optim,15,0,0,2,0,17,88.23529411764706
SimplexOptimizer.java,org.apache.commons.math4.optim.nonlinear.scalar.noderiv,27,0,0,1,0,28,96.42857142857143
SimplexSolver.java,org.apache.commons.math4.optim.linear,51,1,0,15,8,75,68.0
SimplexTableau.java,org.apache.commons.math4.optim.linear,188,13,0,10,5,216,87.03703703703704
SimpsonIntegrator.java,org.apache.commons.math4.analysis.integration,20,0,0,3,0,23,86.95652173913044
Sin.java,org.apache.commons.math4.analysis.function,2,0,0,0,0,2,100.0
Sinc.java,org.apache.commons.math4.analysis.function,77,0,0,21,0,98,78.57142857142857
SingularValueDecomposition.java,org.apache.commons.math4.linear,359,25,0,52,12,448,80.13392857142857
Sinh.java,org.apache.commons.math4.analysis.function,2,0,0,0,0,2,100.0
Skewness.java,org.apache.commons.math4.stat.descriptive.moment,48,1,0,9,0,58,82.75862068965517
SmoothedDataHistogram.java,org.apache.commons.math4.ml.neuralnet.twod.util,0,17,0,0,0,17,0.0
SobolSequenceGenerator.java,org.apache.commons.math4.random,74,1,0,16,0,91,81.31868131868131
SolutionCallback.java,org.apache.commons.math4.optim.linear,4,0,0,0,0,4,100.0
SparseFieldMatrix.java,org.apache.commons.math4.linear,8,13,0,5,0,26,30.76923076923077
SparseFieldVector.java,org.apache.commons.math4.linear,120,65,0,42,0,227,52.863436123348016
SparseGradient.java,org.apache.commons.math4.analysis.differentiation,240,5,0,23,0,268,89.55223880597015
SpearmansCorrelation.java,org.apache.commons.math4.stat.correlation,14,1,0,2,0,17,82.35294117647058
SplineInterpolator.java,org.apache.commons.math4.analysis.interpolation,67,0,0,1,0,68,98.52941176470588
Sqrt.java,org.apache.commons.math4.analysis.function,2,0,0,0,0,2,100.0
StableRandomGenerator.java,org.apache.commons.math4.random,21,23,0,19,0,63,33.33333333333333
StandardDeviation.java,org.apache.commons.math4.stat.descriptive.moment,9,4,0,2,0,15,60.0
StatUtils.java,org.apache.commons.math4.stat,68,8,0,7,0,83,81.92771084337349
StatisticalSummaryValues.java,org.apache.commons.math4.stat.descriptive,19,0,0,12,0,31,61.29032258064516
StepFunction.java,org.apache.commons.math4.analysis.function,12,0,0,1,0,13,92.3076923076923
StepNormalizer.java,org.apache.commons.math4.ode.sampling,23,1,0,7,8,39,58.97435897435898
StepNormalizerBounds.java,org.apache.commons.math4.ode.sampling,2,0,0,0,0,2,100.0
StorelessBivariateCovariance.java,org.apache.commons.math4.stat.correlation,32,3,0,1,0,36,88.88888888888889
StorelessCovariance.java,org.apache.commons.math4.stat.correlation,36,9,0,3,0,48,75.0
Subtract.java,org.apache.commons.math4.analysis.function,2,0,0,0,0,2,100.0
Sum.java,org.apache.commons.math4.stat.descriptive.summary,21,2,0,2,0,25,84.0
SumOfClusterVariances.java,org.apache.commons.math4.ml.clustering.evaluation,8,0,0,2,0,10,80.0
SumOfLogs.java,org.apache.commons.math4.stat.descriptive.summary,13,1,0,2,0,16,81.25
SumOfSquares.java,org.apache.commons.math4.stat.descriptive.summary,15,1,0,2,0,18,83.33333333333334
SummaryStatistics.java,org.apache.commons.math4.stat.descriptive,65,18,0,38,0,121,53.71900826446281
SymmLQ.java,org.apache.commons.math4.linear,158,10,0,46,0,214,73.83177570093457
SymmetricGaussIntegrator.java,org.apache.commons.math4.analysis.integration.gauss,18,0,0,2,0,20,90.0
SynchronizedDescriptiveStatistics.java,org.apache.commons.math4.stat.descriptive,13,2,0,2,0,17,76.47058823529412
SynchronizedMultivariateSummaryStatistics.java,org.apache.commons.math4.stat.descriptive,30,0,0,0,0,30,100.0
SynchronizedRandomGenerator.java,org.apache.commons.math4.random,8,3,0,0,0,11,72.72727272727273
SynchronizedSummaryStatistics.java,org.apache.commons.math4.stat.descriptive,22,16,0,1,0,39,56.41025641025641
TTest.java,org.apache.commons.math4.stat.inference,101,3,0,23,0,127,79.52755905511812
Tan.java,org.apache.commons.math4.analysis.function,2,0,0,0,0,2,100.0
Tanh.java,org.apache.commons.math4.analysis.function,2,0,0,0,0,2,100.0
ThirdMoment.java,org.apache.commons.math4.stat.descriptive.moment,19,0,0,2,0,21,90.47619047619048
ThreeEighthesFieldIntegrator.java,org.apache.commons.math4.ode.nonstiff,8,0,0,0,0,8,100.0
ThreeEighthesFieldStepInterpolator.java,org.apache.commons.math4.ode.nonstiff,5,0,0,0,0,5,100.0
ThreeEighthesStepInterpolator.java,org.apache.commons.math4.ode.nonstiff,87,0,0,0,0,87,100.0
TooManyEvaluationsException.java,org.apache.commons.math4.exception,0,0,0,1,0,1,0.0
TooManyIterationsException.java,org.apache.commons.math4.exception,0,0,0,1,0,1,0.0
TopographicErrorHistogram.java,org.apache.commons.math4.ml.neuralnet.twod.util,0,13,0,0,0,13,0.0
TournamentSelection.java,org.apache.commons.math4.genetics,7,2,0,1,0,10,70.0
TransformUtils.java,org.apache.commons.math4.transform,15,9,0,0,0,24,62.5
Transformer.java,org.apache.commons.math4.ode.events,8,0,0,1,0,9,88.88888888888889
TransformerMap.java,org.apache.commons.math4.util,16,9,0,3,0,28,57.14285714285714
TrapezoidIntegrator.java,org.apache.commons.math4.analysis.integration,31,2,0,5,0,38,81.57894736842105
TriDiagonalTransformer.java,org.apache.commons.math4.linear,120,1,0,3,0,124,96.7741935483871
TricubicInterpolatingFunction.java,org.apache.commons.math4.analysis.interpolation,187,22,1,1,0,211,88.62559241706161
TricubicInterpolator.java,org.apache.commons.math4.analysis.interpolation,73,0,0,6,0,79,92.40506329113924
Ulp.java,org.apache.commons.math4.analysis.function,1,0,0,0,0,1,100.0
UncorrelatedRandomVectorGenerator.java,org.apache.commons.math4.random,8,0,0,0,0,8,100.0
UnifiedDistanceMatrix.java,org.apache.commons.math4.ml.neuralnet.twod.util,0,55,0,0,0,55,0.0
UniformCrossover.java,org.apache.commons.math4.genetics,13,1,0,1,0,15,86.66666666666667
UniformRandomGenerator.java,org.apache.commons.math4.random,4,0,0,0,0,4,100.0
UnivariateObjectiveFunction.java,org.apache.commons.math4.optim.univariate,1,0,0,0,0,1,100.0
UnivariateOptimizer.java,org.apache.commons.math4.optim.univariate,14,0,0,0,0,14,100.0
UnivariatePeriodicInterpolator.java,org.apache.commons.math4.analysis.interpolation,18,0,0,3,0,21,85.71428571428571
UnivariatePointValuePair.java,org.apache.commons.math4.optim.univariate,2,0,0,0,0,2,100.0
UnivariateSolverUtils.java,org.apache.commons.math4.analysis.solvers,51,16,0,26,0,93,54.83870967741935
UnknownParameterException.java,org.apache.commons.math4.ode,1,0,0,0,0,1,100.0
Variance.java,org.apache.commons.math4.stat.descriptive.moment,67,7,0,15,0,89,75.28089887640449
VectorialCovariance.java,org.apache.commons.math4.stat.descriptive.moment,39,18,0,6,0,63,61.904761904761905
VectorialMean.java,org.apache.commons.math4.stat.descriptive.moment,17,6,0,1,0,24,70.83333333333334
WeightedObservedPoint.java,org.apache.commons.math4.fitting,3,0,0,0,0,3,100.0
WeightedObservedPoints.java,org.apache.commons.math4.fitting,3,0,0,0,0,3,100.0
WilcoxonSignedRankTest.java,org.apache.commons.math4.stat.inference,60,0,0,7,2,69,86.95652173913044
WilsonScoreInterval.java,org.apache.commons.math4.stat.interval,24,0,0,0,0,24,100.0
